# 1936初期状態のバカ世界Modにのみ存在する国, バニラの解放国含む
MYS = "countries/Mystery.txt" # 謎
OZY = "countries/Austria.txt" # オージー
PAL = "countries/Palis.txt" # パリ, ToDo
BLX = "countries/Holland.txt" # ベネルクス
CAR = "countries/Saudi Arabia.txt" # 中央アラビア
ISR = "countries/Islael.txt" # イスラエル, ToDo
NTS = "countries/Nantokasutan.txt" # ナントカスタン, ToDo
SBR = "countries/Siberia.txt" # シベリア, ToDo
GDR = "countries/Mongolia.txt" # ガンダーラ
KOR = "countries/Korea.txt" # 韓国
VNM = "countries/Vetnum.txt" # ベトナム, ToDo
IDN = "countries/Indonesia.txt" # インドネシア
BKK = "countries/Bangkok.txt" # バンコク
TWN = "countries/Taiwan.txt" # 台湾, ToDo
EGY = "countries/Egypt.txt" # エジプト
MAR = "countries/Morocco.txt" # モロッコ
KSM = "countries/Kashmir.txt" # カシミール, ToDo
KHM = "countries/Cambodia.txt" # カンボジア, ToDo
WES = "countries/Western Sahara.txt" # サハラ砂漠
KEN = "countries/Kenya.txt" # ケニア, ToDo
AMA = "countries/Amazon.txt" # アマゾン, ToDo
ISL = "countries/Iceland.txt" # アイスランド
EUR = "countries/Europe.txt" # ヨーロッパ(笑), ToDo
NKA = "countries/Nokia.txt" # ノキア, ToDo
INK = "countries/Inka.txt" # インカ帝国, ToDo
SAM = "countries/South Amerika.txt" # 南アメリカ, ToDo
TEX = "countries/Texas.txt" # テキサス, ToDo
LVE = "countries/Las Vegas.txt" # ラスベガス, ToDo
MAC = "countries/McDonald.txt" # マクドナルド, ToDo
CLF = "countries/California.txt" # カリフォルニア, ToDO
GRL = "countries/GreenLand.txt" #グリーンランド, ToDo
HLW = "countries/Hollywood.txt" #ハリウッド, ToDo
NYY = "countries/NewYork Yankees" # ニューヨークヤンキース, ToDo
NEV = "countries/NeverLand.txt" # ネバーランド, ToDo
DIS = "countries/DisneyLand.txt" # ディズニーランド, ToDO
SJK = "countries/Sri Jayawardenepura Kotte.txt" # スリジャヤワルダナプラコッテ, ToDo
ERO = "countries/EromangaIsland.txt" # エロマンガ島, ToDo
MDV = "countries/Maldives.txt" # モルディブ, ToDo
CHI = "countries/ChinaIsland.txt" # 中国(台湾), ToDO
ECU = "countries/Ecuador.txt" # エクアドル, ToDo
LON = "countries/Ireland.txt" # ロンドン
POL = "countries/NorthPoland.txt" # 北極ポーランド, ToDo
NPL = "countries/North Pole.txt" # 北極大陸共和国, ToDO
SPL = "countries/South Pole.txt" # 南極大陸共和国, ToDo
SAN = "countries/SanMarino.txt" # サンマリノ共和国, ToDo
AND = "countries/Andra.txt" # アンドラ, ToDo
LIH = "countries/Liechtenstein.txt" #リヒテンシュタイン, ToDo
UTP = "countries/Utopia.txt" # Utopia, ToDo
CCS = "countries/ChinaSingapore.txt" # 中国領シンガポール, ToDO
NMX = "countries/New Mexico.txt" # ニューメキシコ, ToDo
MLT = "countries/Malta.txt" # マルタ, ToDO
ATL = "countries/Atlantis.txt" # アトランティス, ToDo
MUU = "countries/Muu.txt" # ムー, ToDo
NSI = "countries/North Sentinels Island.txt" # 北センチネル島, ToDo
