#Asia
BKK	= "countries/Asia.txt"	#バンコク
CCS	= "countries/Asia.txt"	#南西諸島
CHI	= "countries/Asia.txt"	#中華
CTO	= "countries/Asia.txt"	#威海衛
DRS	= "countries/Asia.txt"	#シンガポール
EAH	= "countries/Asia.txt"	#地球
EJR	= "countries/Asia.txt"	#東方エルサレム
ENG	= "countries/Asia.txt"	#上
ERO	= "countries/Asia.txt"	#エロマンガ
FRP	= "countries/Asia.txt"	#太平洋
GEN	= "countries/Asia.txt"	#元寇
GER	= "countries/Asia.txt"	#志'
JAP	= "countries/Asia.txt"	#三'
KSM	= "countries/Asia.txt"	#カシミール
MME	= "countries/Asia.txt"	#満州＝蒙古
MUU	= "countries/Asia.txt"	#ムー
NSI	= "countries/Asia.txt"	#北センチネル島
NTS	= "countries/Asia.txt"	#ナントカスタン
ORI	= "countries/Asia.txt"	#沖縄諸島
PPP	= "countries/Asia.txt"	#プププ・ランド
PRC	= "countries/Asia.txt"	#漢
PRK	= "countries/Asia.txt"	#北朝鮮
RAJ	= "countries/Asia.txt"	#國'
SBR	= "countries/Asia.txt"	#シベリア
SCC	= "countries/Asia.txt"	#上海
SJK	= "countries/Asia.txt"	#スリジャヤワルダナプラコッテ
TBH	= "countries/Asia.txt"	#徳川
TWN	= "countries/Asia.txt"	#台湾（タイ）
SWK = "countries/Asia.txt"	#サラワク
SOS = "countries/Asia.txt"	#スールー
HRH = "countries/Asia.txt"
#Middle East

#Commonwealth

#Western Europe
ADR	= "countries/Western Europe.txt"	#アンドラ
ATL	= "countries/Western Europe.txt"	#アトランティス
BLX	= "countries/Western Europe.txt"	#ベネルクス
CLF	= "countries/Western Europe.txt"	#カリフォルニア
DIS	= "countries/Western Europe.txt"	#ディズニーランド
EUR	= "countries/Western Europe.txt"	#ヨーロッパ
GAT	= "countries/Western Europe.txt"	#ガトランチス
GRL	= "countries/Western Europe.txt"	#グリーンランド
HLW	= "countries/Western Europe.txt"	#ハリウッド
KAL	= "countries/Western Europe.txt"	#カリオストロ
LIH	= "countries/Western Europe.txt"	#リヒテンシュタイン
LON	= "countries/Western Europe.txt"	#ロンドン
LVE	= "countries/Western Europe.txt"	#ラスベガス
MAC	= "countries/Western Europe.txt"	#マクドナルド
MCO	= "countries/Western Europe.txt"	#モナコ
NEV	= "countries/Western Europe.txt"	#ネバーランド
NKA	= "countries/Western Europe.txt"	#ノキア
NMR	= "countries/Western Europe.txt"	#モレネ
NMX	= "countries/Western Europe.txt"	#ニューメキシコ
NPL	= "countries/Western Europe.txt"	#北極大陸
NYY	= "countries/Western Europe.txt"	#ニューヨークヤンキース
OZY	= "countries/Western Europe.txt"	#オージー
PAL	= "countries/Western Europe.txt"	#パリ
PEG	= "countries/Western Europe.txt"	#ペンギン
POS	= "countries/Western Europe.txt"	#シーランド
SAN	= "countries/Western Europe.txt"	#サンマリノ
SPL	= "countries/Western Europe.txt"	#南極大陸
TEX	= "countries/Western Europe.txt"	#テキサス
TLM	= "countries/Western Europe.txt"	#トルメキア
UTP	= "countries/Western Europe.txt"	#ユートピア
VAT	= "countries/Western Europe.txt"	#バチカン
RAL = "countries/Western Europe.txt"	#アルザス=ロレーヌ

#Eastern Europe
BTB	= "countries/Eastern Europe.txt"	#バトル
BTG	= "countries/Eastern Europe.txt"	#バトル
BTL	= "countries/Eastern Europe.txt"	#バトル
BTP	= "countries/Eastern Europe.txt"	#バトル
BTW	= "countries/Eastern Europe.txt"	#バトル
BTY	= "countries/Eastern Europe.txt"	#バトル
DPK	= "countries/Eastern Europe.txt"	#トランスニストリア
MOS	= "countries/Eastern Europe.txt"	#モスクワ
MYS	= "countries/Eastern Europe.txt"	#謎

#Africa
CAR	= "countries/Africa.txt"	#中央アフリカ

#South America
AMA	= "countries/South America.txt"	#アマゾン
INK	= "countries/South America.txt"	#インカ
RED	= "countries/South America.txt"	#レドンダ
SAM	= "countries/South America.txt"	#南アメリカ
